{
  "aa": "dj",
  "ab": "ge",
  "ae": "ir",
  "af": "za",
  "ak": "gh",
  "am": "et",
  "an": "es",
  "ar": "sa",
  "as": "in",
  "av": "ru",
  "ay": "bo",
  "az": "az",
  "ba": "ru",
  "be": "by",
  "bg": "bg",
  "bi": "vu",
  "bm": "ml",
  "bn": "bd",
  "bo": "cn-xz",
  "br": "fr",
  "bs": "ba",
  "ca": "es",
  "ce": "ru",
  "ch": "gu",
  "co": "fr",
  "cr": "ca",
  "cs": "cz",
  "cu": "ru",
  "cv": "ru",
  "cy": "gb-wls",
  "da": "dk",
  "de": "de",
  "dv": "mv",
  "dz": "bt",
  "ee": "gh",
  "el": "gr",
  "en": "gb",
  "eo": "gb",
  "es": "es",
  "et": "ee",
  "eu": "es",
  "fa": "ir",
  "ff": "sn",
  "fi": "fi",
  "fj": "fj",
  "fo": "fo",
  "fr": "fr",
  "fy": "nl",
  "ga": "ie",
  "gd": "gb-sct",
  "gl": "es",
  "gn": "py",
  "gu": "in",
  "gv": "im",
  "ha": "ng",
  "he": "il",
  "hi": "in",
  "ho": "pg",
  "hr": "hr",
  "ht": "ht",
  "hu": "hu",
  "hy": "am",
  "hz": "na",
  "ia": "gb",
  "id": "id",
  "ie": "gb",
  "ig": "ng",
  "ii": "cn",
  "ik": "us",
  "io": "gb",
  "is": "is",
  "it": "it",
  "iu": "ca",
  "ja": "jp",
  "jv": "id",
  "ka": "ge",
  "kg": "cd",
  "ki": "ke",
  "kj": "na",
  "kk": "kz",
  "kl": "gl",
  "km": "kh",
  "kn": "in",
  "ko": "kr",
  "kr": "ne",
  "ks": "in",
  "ku": "iq",
  "kv": "ru",
  "kw": "gb",
  "ky": "kg",
  "la": "va",
  "lb": "lu",
  "lg": "ug",
  "li": "li",
  "ln": "cd",
  "lo": "la",
  "lt": "lt",
  "lu": "lu",
  "lv": "lv",
  "mg": "mg",
  "mh": "mh",
  "mi": "nz",
  "mk": "mk",
  "ml": "in",
  "mn": "mn",
  "mr": "in",
  "ms": "my",
  "mt": "mt",
  "my": "mm",
  "na": "nr",
  "nb": "no",
  "nd": "zw",
  "ne": "np",
  "ng": "na",
  "nl": "nl",
  "nn": "no",
  "no": "no",
  "nr": "za",
  "nv": "us",
  "ny": "mw",
  "oc": "fr",
  "oj": "ca",
  "om": "et",
  "or": "in",
  "os": "ru",
  "pa": "in",
  "pi": "in",
  "pl": "pl",
  "ps": "af",
  "pt": "pt",
  "qu": "pe",
  "rm": "ch",
  "rn": "bi",
  "ro": "ro",
  "ru": "ru",
  "rw": "rw",
  "sa": "in",
  "sc": "it",
  "sd": "pk",
  "se": "no",
  "sg": "cf",
  "si": "lk",
  "sk": "sk",
  "sl": "si",
  "sm": "ws",
  "sn": "zw",
  "so": "so",
  "sq": "al",
  "sr": "rs",
  "ss": "sz",
  "st": "ls",
  "su": "id",
  "sv": "se",
  "sw": "tz",
  "ta": "in",
  "te": "in",
  "tg": "tj",
  "th": "th",
  "ti": "er",
  "tk": "tm",
  "tl": "ph",
  "tn": "bw",
  "to": "to",
  "tr": "tr",
  "ts": "za",
  "tt": "ru",
  "tw": "gh",
  "ty": "pf",
  "ug": "cn",
  "uk": "ua",
  "ur": "pk",
  "uz": "uz",
  "ve": "za",
  "vi": "vn",
  "vo": "gb",
  "wa": "be",
  "wo": "sn",
  "xh": "za",
  "yi": "il",
  "yo": "ng",
  "za": "cn",
  "zh": "cn",
  "zu": "za"
}
